1 13 31
###############################
#p s   *s *  1 * 1 *  * * *   #
# # # #*# # #*#*# # # #*#*#*# #
#  xs     *f*  *  2   * 1 * * #
# # # # # #*# # #*#*# # # # #*#
#f    s    x b*  *  *   2     #
# # # # # # # # # #*# #*# # # #
#*  *      *  *      *        #
# # # # #*# # # #*#*# # # # # #
#*    **  *       *  2        #
# #*# # # # # # #*# # # # # # #
#           *   *  *          #
###############################
